8
9
7
1
0
0
2
2
2	3	11	9	10	9	10	3	9
10	9	4	12	12	12	14	1	12
12	6	9	14	5	6	5	10	13
6	9	12	6	9	10	3	7	5
8	12	6	11	5	6	3	3	9
14	5	10	5	10	11	3	3	5
12	8	14	1	12	6	3	3	9
4	6	7	3	7	1	2	3	5