8
9
0
3
0
8
0
0
2	3	11	11	11	3	11	11	9
10	11	15	15	15	11	15	15	13
14	15	15	7	15	15	15	15	13
12	6	13	8	14	15	15	13	12
12	10	15	15	15	15	15	5	12
12	14	15	15	15	15	15	9	12
14	15	15	7	15	15	15	13	12
6	7	7	3	7	7	7	7	5