8
8
0
0
1
1
0
0
8	10	11	11	11	3	11	1
14	15	15	15	15	11	13	8
14	15	15	15	13	14	15	13
14	7	15	13	14	7	15	13
14	11	13	14	15	11	15	13
4	12	14	15	15	13	6	13
2	13	14	13	6	15	11	13
2	7	7	7	1	6	7	5