9
14
1
13
4
0
4
13
2	3	11	11	9	10	3	11	1	2	11	3	3	9
8	8	12	4	12	12	2	15	3	3	5	2	3	13
14	15	7	11	15	15	3	15	11	11	3	3	11	13
12	12	2	13	12	14	11	13	12	6	3	3	13	12
12	12	10	13	12	12	12	12	14	3	3	9	12	12
12	12	12	14	13	12	14	15	15	3	3	13	12	12
12	12	12	12	12	12	12	12	14	3	3	13	12	12
12	12	12	12	12	12	12	12	14	3	3	13	12	12
6	7	7	7	7	7	7	7	7	3	3	7	7	5