9
14
5
13
5
12
3
6
10	9	10	3	11	3	3	11	11	1	10	3	3	9
12	6	7	9	12	10	3	13	14	1	12	8	8	12
14	9	10	7	7	15	3	15	7	9	12	14	15	13
12	14	15	11	9	12	2	15	9	14	13	12	12	12
12	12	12	12	12	14	9	12	12	12	12	14	7	5
14	7	7	7	13	12	14	13	12	12	12	12	8	10
6	3	11	9	6	7	13	14	7	13	6	15	5	12
8	8	12	12	2	3	13	14	11	7	3	7	9	12
6	7	7	7	3	3	7	5	6	3	3	3	7	5